00000000000000000000000000000000000000000000000000
00000000000000000000000000000000000000000000000000
00000000000000000000000000000000000000000000000000
00000000000000000000000000000000000000000000000000
00000000000000000000000000000000000000000000000000
0000000000000000000000000000000C000000000000000000
0000000VTRRBLJPTNSNFWZQFJ000000B000000000000000000
0000000M                A000000Y000000000000000000
0000000F                A000000N000000000000000000
0000000D                R0000000000000000000000000
0000000R                W0RE0000000000000001000000
0000000SOFSBCNUVQHFFBSAQX0LL0000000000000000000000
00000000000000000000000000NM00KHOPKMCOQHNWNKUEWH00
00000000000000000000000000PA00S                Q00
0000000000000ECDY000000000PQ00M                G00
0000000000000G  G000000000FW00B                B00
0000000000000X  X0000000000000U                Q00
0000000000000PKLO0000000000000CLJJIVSWMDKQTBXIXM00
00000000000000000000000000000000000000000000000000
00000000000000000000000000000000000000000000000000