00000000000000000000000000000000000000000000000000
00000000000000000000000000000000000000000000000000
00000000000000000000000000000000000000000000000000
00000000000000000000000000000000000000000000000000
00000000000000000000000000000000000000000000000000
00000000000000000000000000000000000000000000000000
0000000VTRRBLJPTNSNFWZQFJ0000000000000000000000000
0000000M                A0000000000000000000000000
0000000F                A0000000000000000000000000
0000000M                R0000000000000000000000000
0000000R                W0RE0000000000000001000000
0000000SOFSBCNUVQHFFBSAQX0LL0000000000000000000000
00000000000000000000000000NM00KHOPKMCOQHNWNKUEWH00
00000000000000000000000000GA00S                Q00
00000000000000000000000000PQ00M                X00
00000000000000000000000000FW00B                B00
000000000000000000000000000000U                Q00
000000000000000000000000000000CLJJIVSWMDKQTBXIXM00
00002000000000000000000000000000000000000000000000
00000000000000000000000000000000000000000000000000










