00000000TDHEFVTGUDQRIYIGKJWXGQICLQQDHYQ00000000000
00000000000000000000000000000000000000000000000000
00000000000000000000000000000000000000000000000000
00000000000000000000000000000000000000000000000000
00000000GXQUYXCHGUJHSRMLHXBUNABAKCLRSLW00000000000
00000000U                             H00000000000
00000000HDXRLJPNVAWQVIEMUKVQEATHKIHMXEW00000000000
00000000000000000000000000000000000000000000000000
00000000000000000000000000000000000000000000000000
00000000WCADGVCGYTONPSCSTBWKZRPAULQPOYD00000000000
00000000C                             Q00000000000
00000000RJYUQCSGWTSIDOCNXNFNENASMJOUXTO00000000000
00000000000000000000000000000000000000000000000000
00000000000000000000000000000000000000000000000000
00000000TNBJNDYYPPCMMEMGVSKTPXYFOSMJQXV00000000000
00000000V                             P00000000000
00000000APDHLJQABBXOWRHPAWQBPDCRIIMENPY00000000000
00000000000000000000000000000000000000000000000000
22222222222222222222222222222222222222200000010000
22222222222222222222222222222222222222200000000000